##############################
# ..      ..    ##       ..  #
#  ## S..         .. S..##   #
#  #       ..  ..       ..#  #
#  #..  ##       ##  ..#..   #
#     ..     ..         ..   #
# ~~    ~~ ~~ ~~ ~~    ~~ ~~ #
#      ..     ..   ##      ..#
#  #..  ##        ..#   ..#  #
#     ..       ..        ..  #
#  ##   ..###        ##  ##  #
# ..      ..       ..     .. #
# S ..             ..    ..S #
# ..      ..    ##       ..  #
##############################